###################################################################################################################
###################################################################################################################
###################################################################################################################
###################################################################################################################
##############.....................................################################################################
##############.....................................################################################################
##############.....................................################################################################
##############.....................................################################################################
##############.....................................################################################################
##############.....................................################################################################
##############.....................................################################################################
##############...............######################################################################################
##############...............######################################################################################
##############...............######################################################################################
##############...............######################################################################################
####################...############################################################################################
####################...############################################################################################
####################...############################################################################################
####################...############################################################################################
####################...############################################################################################
################...........########################################################################################
################...........########################################################################################
################...........########################################################################################
################...........########################################################################################
################...........########################################################################################
################...........########################################################################################
################.....P.....########################################################################################
################...........########################################################################################
################...........########################################################################################
################...........########################################################################################
###################################################################################################################
###################################################################################################################
###################################################################################################################
###################################################################################################################
###################################################################################################################
###################################################################################################################
###################################################################################################################
###################################################################################################################
###################################################################################################################
###################################################################################################################
