###################################################################################################################
###################################################################################################################
###################################################################################################################
###################################################################################################################
###################################################################################################################
###################################################################################################################
#################################...............###################################################################
#################################...............###################################################################
#################################...............###################################################################
#################################...............###################################################################
#################################...............###################################################################
#################################...............###################################################################
##################..............................###################################################################
##################..............................###################################################################
##################..............................###################################################################
##################...S..........................###################################################################
##################..............................###################################################################
##################.......########...............###################################################################
##################       ########...............###################################################################
##################  ...  ########...............###################################################################
##################  ...  ########...............###################################################################
##################  ...  ##########################################################################################
##################       ##########################################################################################
##################  ...  ##########################################################################################
##################  ...  ##########################################################################################
##################  ...  ##########################################################################################
##################       ##########################################################################################
##################.......##########################################################################################
##################.......##########################################################################################
##################.......##########################################################################################
##################.......##########################################################################################
##################.......##########################################################################################
##################.......##########################################################################################
##################.......##########################################################################################
##################.......##########################################################################################
####################...############################################################################################
####################...############################################################################################
####################...############################################################################################
####################...############################################################################################
##################.......##########################################################################################
##################.......##########################################################################################
##################.......##########################################################################################
##################...P...##########################################################################################
##################.......##########################################################################################
##################.......##########################################################################################
###################################################################################################################
###################################################################################################################
###################################################################################################################
###################################################################################################################
###################################################################################################################
###################################################################################################################
###################################################################################################################
###################################################################################################################
###################################################################################################################
